n	名词	T
nr	人名	T
nr1	汉语姓氏	F
nr2	汉语名字	F
nrj	日语人名	F
nrf	音译人名	f
ns	地名	T
nsf	音译地名	F
nt	机构团体名	T
nz	其它专名	F
nl	名词性惯用语	F
ng	名词性语素	F
nw	新词	T
t	时间词	F
tg	时间词性语素	F
s	处所词	F
f	方位词	F
v	动词	T
vd	副动词	T
vn	名动词	T
vshi	动词“是”	F
vyou	动词“有”	F
vf	趋向动词	F
vx	形式动词	F
vi	不及物动词（内动词）	T
vl	动词性惯用语	F
vg	动词性语素	F
a	形容词	F
ad	副形词	F
an	名形词	F
ag	形容词性语素	F
al	形容词性惯用语	F
b	区别词	F
bl	区别词性惯用语	F
z	状态词	F
r	代词	F
rr	人称代词	F
rz	指示代词	F
rzt	时间指示代词	F
rzs	处所指示代词	F
rzv	谓词性指示代词	F
ry	疑问代词	F
ryt	时间疑问代词	F
rys	处所疑问代词	F
ryv	谓词性疑问代词	F
rg	代词性语素	F
m	数词	F
mq	数量词	F
q	量词	F
qv	动量词	F
qt	时量词	F
d	副词	F
p	介词	F
pba	介词“把”	F
pbei	介词“被”	F
c	连词	F
cc	并列连词	F
u	助词	F
uzhe	着	F
ule	了,喽	F
uguo	过	F
ude1	的,底	F
ude2	地	F
ude3	得	F
usuo	所	F
udeng	等,等等,云云	F
uyy	一样,一般,似的,般	F
udh	的话	F
uls	来讲,来说,而言,说来	F
uzhi	之	F
ulian	连（“连小学生都会”）	F
e	叹词	F
y	语气词	F
o	拟声词	F
h	前缀	F
k	后缀	F
x	字符串	F
xx	非语素字	F
xu	网址URL	F
w	标点符号	F
wkz	左括号，全角：（〔［｛《【〖〈半角：([{<	F
wky	右括号，全角：）〕］｝》】〗〉半角：)]{>	F
wyz	左引号，全角：“‘『	F
wyy	右引号，全角：”’』	F
wj	句号，全角：。	F
ww	问号，全角：？半角：?	F
wt	叹号，全角：！半角：!	F
wd	逗号，全角：，半角：,	F
wf	分号，全角：；半角：;	F
wn	顿号，全角：、	F
wm	冒号，全角：：半角：:	F
ws	省略号，全角：………	F
wp	破折号，全角：——－－——－半角：-------	F
wb	百分号千分号，全角：％‰半角：%	F
wh	单位符号，全角：￥＄￡°℃半角：$	F