北京	北京
天津	天津
上海市	上海
重庆市	重庆
香港	香港
澳门	澳门
台湾	台北
海南	海口
江苏	南京
河北	石家庄
山西	太原
内蒙古	呼和浩特
辽宁	沈阳
吉林	长春
黑龙江	哈尔滨
浙江	杭州
安徽	合肥
福建	福州
江西	南昌
山东	济南
河南	郑州
湖北	武汉
湖南	长沙
广东	广州
广西	南宁
四川	成都
贵州	贵阳
云南	昆明
西藏	拉萨
陕西	西安
甘肃	兰州
青海	西宁
宁夏	银川
新疆	乌鲁木齐
